#######
#.....#
#.OO@.#
#.....#
#######
