#######
#...#.#
#.....#
#.....#
#.....#
#.....#
#.OOO@#
#.OOO.#
#..O..#
#.....#
#.....#
#######
