#######
#.....#
#.#O..#
#..O@.#
#.....#
#######
