#######
#.....#
#.O.O@#
#..O..#
#..O..#
#.....#
#######
