######
#....#
#.O..#
#.OO@#
#.O..#
#....#
######
