#######
#.....#
#.O#..#
#..O@.#
#.....#
#######
